R 960 600

NO ./textures/wolf_textures/wall_n.xpm
SO ./textures/wolf_textures/wall_s.xpm
WE ./textures/wolf_textures/wall_w.xpm
EA ./textures/wolf_textures/wall_e.xpm
S ./path_to_the_sprite_texture
F 167,147,144
C 167,167,171

11111111111111111111111111111
10000000001100100000000000001
101100000111000000000S0000001
10010000000000000000000000001
11111111101100000111010011111
10000000001100000111011111111
11110111111111011100000010001
11110111111111011101010010001111111
11000000110101011100000010000000001
10000000000000001100000010000000001
10000000200000001101010010001111111
1100000111010101111101111000111
11110111 1110101 101111010001
11111111 1111111 111111111111