R 960 600

NO ./textures/wolf_textures/wall_n.xpm
SO ./textures/wolf_textures/wall_s.xpm
WE ./textures/wolf_textures/wall_w.xpm
EA ./textures/wolf_textures/wall_e.xpm
S ./path_to_the_sprite_texture
F 167,147,144
C 167,167,171

11111111111
10010100001
10112110001
10000000001
10000000001
10000000001
1000N000001
10000000001
10000000001
11111111111