R 960 600

NO ./textures/wall_n.xpm
SO ./textures/wall_s.xpm
WE ./textures/wall_w.xpm
EA ./textures/wall_e.xpm
S ./textures/sprite.xpm
F 167,147,144
C 167,167,171

1111111111111
1000000000001
1000000000001
10N0000000001
1000000000001
1111111111111